5 5
tileMap
1 1 1 1 1 
1 0 1 0 1 
1 1 1 1 1 
0 1 1 1 0 
0 0 0 0 0 
collisionMap
1 1 1 1 1 
1 1 1 1 1 
1 1 1 1 1 
1 1 1 1 1 
1 1 1 1 1 
